       SO                        textures/wall.xpm


                F 50,5,0 
              

NO     textures/wall2.xpm



EA  textures/wall_green.xpm
WE     textures/wall2_green.xpm
    C     15,20,60


111111111111111111111111111111111111111111111111111111
100000000000000000000000000000000000000000000000000001
100000000000000000000000000000000000000000000000000001
100000000000000000000000000000000000000000000000000001
100001111111000000100000001111100100011111000000000001
100001000000000000100000001000100000010001000000000001
100001000000000001110000001000100100010001000000000001
100001111110000010001000001111100100010001000000000001
100001000000000111111100001000100100010001000000000001
100001000000001000000010001000100100010001000000000001
100001000000010000000001001111100100011111000000000001
100000000000000000000000000000000000000000000000000001
100000000000000000000000000000000000000000000000000001
100000000000000000000000000000000000000000000000000001
100000000000000000000000000000000000000000000000000001
100000111111111000111110000011111111100011111000000001
100000100000000000100010000010000000000010001000000001
100000100000000000100010000010000000000010001000000001
100000100000000000100010000010000000000010001000000001
100000100000000000100010000010000000000010001000000001
100000100000000000100010000010000000000010001000000001
100000111111111000111110000011111111100011111000000001
100000000000000000000000000000000000000000000000000001
100000000000000000000000000000000000000000000000000001
100000000000000000000000000000000000000000000000000001
100000000000000000000000000000000000000000000000000001
100000000000000000000000000000000000000000000000000001
100000000000000000000000000000000000000000000000000001
100000000000000000000000000000000000000000000000000001
100000000000000000000000000000000000000000000000000001
100000000000000000000000000000000000000000000000000001
100000000000000000000000000000000000000000000000000001
100000000000000000000000000000000000000000000000000001
100000000000000000000000000000000000000000000000000001
100000000000000000000000000000000000000000000000000001
100000000000000000000000000000000000000000000000000001
100000000000000000000000000000000000000000000000000001
1000000000000000000000000N0000000000000000000000000001
111111111111111111111111111111111111111111111111111111
