       NO                        textures/wall.xpm
NO     textures/wall2.xpm


                F 50,2147483648,0 
              




EA  textures/wall_green.xpm
WE     textures/wall2_green.xpm
    C     15,20,60
 11111111111111111111111
100000000100000000000011000000010000
110000000000000000010001111111111111
100000000000000000000001111111111001
100000000000000000000001111110000101
100000000000000011111001000000000001
100000000000000000000100000000000001
1000000001101110110000001111111111111
100000001000000001000001
100000010000000000000001
100000010000000000000001
100000000000000000000001
100000000000000000000001
100000000000000000000001
100000000000000000000001
100000000000000000000001
100000000000000000000001
100000000000000000000001
10000000000000E000000001
100000000000000000000001
100000000000000000000001
100000000000000000000001
100000000000000000000001
100000000000000000000001
100000000000000000000001
100000000000000000000001
100000000000001000000001
100000000000000000000001
100000100000000000000001
100000000000000000000001
100000000000000000100001
100000000000000000000001
100000000010000000000001
100100000000000000000001
100000000000000100000001
110000000000000000000001
111111111111111111111111
